111 11 11
1
1 1 1 111
    11111
11  111 1
1X 1111
1       1
111 11111
111 11111