11111
1   1
111 1
11  1
111 1
111 1